"","Nombre","Equipo","Minutos","T.Amarillas","Goles","Fueras.De.Juego","Faltas.Recibidas","Faltas.Cometidas","Centros","Corners","Entradas","Duelos","Duelos.Cuerpo","Duelos.Aire","Pases","Pases.Cortos","Pases.Largos","Pases.Hueco","Tiros","Tiros.Puerta","Asistencias","Regates.Exito","Regates.Fracaso","Recuperaciones","Entradas.Exito","Entradas.Fracaso","Duelos.Cuerpo.Exito","Duelos.Cuerpo.Fracaso","Duelos.Aire.Exito","Duelos.Aire.Fracaso","Precision.Tiros","Regates","Precision.Regates","Importante"
"1","Aarón Martín","ESP",2815,6,0,0,20,29,131,17,56,269,208,61,975,880,93,2,4,2,0,35,17,151,36,20,109,99,20,41,0.5,52,0.673076923076923,1
"2","Achraf Hakimi","RMA",757,0,2,1,6,8,30,0,21,112,93,19,407,385,22,0,3,3,0,22,9,50,15,6,49,44,9,10,1,31,0.709677419354839,0
"3","Adán","BET",2700,4,0,0,3,1,0,0,1,13,8,5,1124,534,590,0,0,0,2,5,0,242,0,1,8,0,4,1,0,5,1,1
"4","Aday","GIR",1833,10,2,6,15,39,132,3,17,196,140,56,720,624,95,1,25,14,0,27,15,97,15,2,58,82,38,18,0.56,42,0.642857142857143,0
"5","Adnan Januzaj","RSO",1579,4,3,6,60,32,29,34,16,320,301,19,474,435,37,2,40,14,5,67,57,74,11,5,143,158,6,13,0.35,124,0.540322580645161,0
"7","Adrián","DEP",2346,1,9,12,29,16,29,1,24,364,207,157,860,823,31,6,47,20,6,38,31,116,14,10,86,121,80,77,0.425531914893617,69,0.550724637681159,1
"8","Adrián","MGA",2341,9,3,2,31,39,14,2,40,348,188,160,1048,929,117,2,26,12,0,8,5,147,25,15,75,113,67,93,0.461538461538462,13,0.615384615384615,1
"9","Aduriz","ATH",2149,5,9,35,39,42,19,0,11,335,137,198,490,472,16,2,52,28,1,19,5,45,8,3,60,77,108,90,0.538461538461538,24,0.791666666666667,1
"11","Aissa Mandi","BET",3025,9,1,1,26,34,2,0,54,253,147,106,2128,1966,161,1,11,2,0,13,3,135,35,19,92,55,59,47,0.181818181818182,16,0.8125,1
"13","Alberto Aquilani","LPA",1298,4,0,1,14,18,7,0,33,133,107,26,996,860,132,4,9,4,0,7,2,94,19,14,52,55,13,13,0.444444444444444,9,0.777777777777778,0
"15","Alcácer","BAR",694,0,4,7,9,2,3,3,4,62,38,24,223,217,3,3,13,7,3,3,7,28,3,1,16,22,7,17,0.538461538461538,10,0.3,0
"16","Alcalá","GIR",690,3,1,2,3,11,4,0,9,60,26,34,288,206,82,0,7,3,0,5,0,26,5,4,16,10,20,14,0.428571428571429,5,1,0
"17","Aleix García","GIR",843,3,1,0,5,5,12,35,24,72,59,13,527,437,90,0,8,3,0,6,2,84,14,10,35,24,10,3,0.375,8,0.75,0
"20","Alexis","ALA",2184,6,1,2,14,20,6,0,33,148,98,50,632,508,124,0,9,3,0,6,2,112,24,9,52,46,29,21,0.333333333333333,8,0.75,1
"21","Álvaro ","VIL",2899,13,0,3,30,32,7,0,38,233,117,116,1436,1174,262,0,15,3,2,2,2,132,26,12,64,53,64,52,0.2,4,0.5,1
"23","Álvaro Medrán","ALA",1014,2,2,2,14,23,7,5,21,130,114,16,502,424,75,3,10,6,0,18,12,70,15,6,53,61,7,9,0.6,30,0.6,0
"24","Álvaro Odriozola","RSO",2917,3,0,9,31,25,154,1,41,268,234,34,1294,1235,58,1,6,5,4,32,55,178,27,14,104,130,5,29,0.833333333333333,87,0.367816091954023,1
"26","Amath","GET",2883,9,3,10,62,72,21,0,77,504,434,70,558,500,55,3,30,13,3,43,55,183,54,23,180,254,21,49,0.433333333333333,98,0.438775510204082,1
"27","Amrabat","LEG",1620,5,2,25,36,54,60,2,19,302,266,36,400,370,25,5,29,18,4,40,31,76,10,9,94,172,13,23,0.620689655172414,71,0.563380281690141,0
"28","Andone","DEP",1630,6,7,17,19,59,17,0,9,289,182,107,287,281,6,0,49,22,3,17,32,50,7,2,45,137,32,75,0.448979591836735,49,0.346938775510204,0
"31","Andreas Pereira","VAL",1076,5,1,1,21,20,56,9,26,170,145,25,335,310,24,1,10,6,3,17,20,59,15,11,64,81,13,12,0.6,37,0.459459459459459,0
"35","Ángel ","GET",2298,6,13,32,36,48,20,0,28,358,212,146,369,342,24,3,55,31,2,22,25,62,19,9,84,128,31,115,0.563636363636364,47,0.468085106382979,1
"36","Ángel Correa","ATM",2262,3,8,6,49,47,30,3,41,437,400,37,850,791,49,10,39,27,4,69,58,168,29,12,159,241,6,31,0.692307692307692,127,0.543307086614173,1
"37","Antonio Luna","LEV",2021,4,0,3,15,22,58,0,39,150,120,30,729,578,150,1,1,0,2,10,5,142,26,13,61,59,16,14,0,15,0.666666666666667,1
"38","Antunes","GET",2797,14,0,1,36,50,114,52,58,281,239,42,889,638,248,3,19,3,2,18,21,172,44,14,111,128,19,23,0.157894736842105,39,0.461538461538462,1
"40","Arbilla","EIB",2411,8,2,0,11,26,10,2,38,195,115,80,1497,1064,433,0,13,4,1,20,1,238,30,8,69,46,44,36,0.307692307692308,21,0.952380952380952,1
"41","Aritz Elustondo","RSO",1598,1,3,3,11,21,9,0,32,157,86,71,951,842,107,2,10,5,2,3,5,68,20,12,45,41,43,28,0.5,8,0.375,0
"45","Bacca","VIL",2511,9,15,40,20,22,11,2,10,197,136,61,520,495,24,1,57,35,6,34,18,54,2,8,64,72,23,38,0.614035087719298,52,0.653846153846154,1
"46","Bakkali","DEP",906,5,0,4,20,14,32,9,12,124,107,17,261,249,11,1,19,6,0,17,17,46,10,2,49,58,4,13,0.315789473684211,34,0.5,0
"47","Bale","RMA",1803,5,16,13,16,25,55,0,19,205,142,63,696,644,50,2,65,33,2,31,21,37,13,6,66,76,33,30,0.507692307692308,52,0.596153846153846,0
"48","Balenziaga","ATH",1554,1,0,0,16,21,50,0,34,147,120,27,576,508,68,0,3,0,2,14,10,91,24,10,64,56,14,13,0,24,0.583333333333333,0
"49","Banega","SEV",2397,9,3,2,51,42,54,103,71,406,381,25,2132,1884,238,10,29,13,3,83,38,244,53,18,204,177,11,14,0.448275862068966,121,0.685950413223141,1
"50","Barbosa","VIL",1125,0,0,0,3,0,0,0,0,4,3,1,278,108,170,0,0,0,0,0,0,93,0,0,3,0,1,0,0,0,0,0
"51","Barragán","BET",2377,7,0,4,19,51,92,0,59,250,183,67,1316,1222,92,2,7,4,6,14,23,132,42,17,90,93,46,21,0.571428571428571,37,0.378378378378378,1
"52","Bartra","BET",1421,6,1,0,16,20,2,0,38,195,118,77,1091,915,173,3,11,4,0,22,2,114,28,10,76,42,51,26,0.363636363636364,24,0.916666666666667,0
"53","Beauvue","LEG",1670,4,2,17,27,30,11,0,5,311,122,189,302,288,12,2,30,9,0,13,10,31,3,2,39,83,73,116,0.3,23,0.565217391304348,0
"55","Ben Yedder","SEV",1699,1,9,21,20,17,8,0,12,182,109,73,471,455,15,1,39,28,3,16,14,60,8,4,48,61,15,58,0.717948717948718,30,0.533333333333333,0
"56","Benzema","RMA",2156,0,5,16,11,19,6,1,13,187,149,38,868,825,35,8,48,18,10,33,16,43,8,5,57,92,9,29,0.375,49,0.673469387755102,1
"57","Beñat","ATH",1115,3,0,0,15,17,32,49,28,119,108,11,727,629,96,2,10,3,2,6,6,105,20,8,48,60,6,5,0.3,12,0.5,0
"58","Bernardo","GIR",2868,7,0,3,16,40,1,0,36,267,106,161,1169,889,280,0,19,4,3,2,2,126,22,14,52,54,104,57,0.210526315789474,4,0.5,1
"59","Bigas","LPA",896,3,0,1,6,12,0,0,14,70,50,20,588,516,72,0,3,1,0,10,2,53,9,5,29,21,12,8,0.333333333333333,12,0.833333333333333,0
"60","Boateng","LEV",1270,5,6,9,38,41,3,0,4,267,124,143,221,212,9,0,35,16,0,15,9,34,3,1,56,68,74,69,0.457142857142857,24,0.625,0
"62","Bonera","VIL",1190,4,0,0,11,14,0,0,16,70,44,26,566,470,95,1,2,0,1,1,0,48,11,5,25,19,18,8,0,1,1,0
"63","Borja Bastón","MGA",977,2,2,9,7,16,5,0,9,128,60,68,229,222,4,3,21,10,0,3,7,20,7,2,19,41,26,42,0.476190476190476,10,0.3,0
"64","Borja G.","GIR",2812,2,2,0,110,26,66,42,39,369,325,44,1315,1170,133,12,40,10,5,40,41,190,18,21,186,139,15,29,0.25,81,0.493827160493827,1
"69","Bounou","GIR",2655,2,0,0,1,1,0,0,1,11,5,6,790,118,672,0,0,0,0,1,0,246,1,0,2,3,4,2,0,1,1,1
"70","Bóveda","DEP",1191,3,0,1,4,21,22,0,36,134,84,50,470,405,65,0,0,0,1,3,4,56,27,9,43,41,25,25,0,7,0.428571428571429,0
"72","Bruno","GET",1538,5,0,2,10,19,0,0,25,136,66,70,336,249,87,0,3,0,0,1,0,59,18,7,35,31,40,30,0,1,1,0
"74","Burgui","ALA",1034,0,1,5,19,12,12,2,10,102,91,11,336,310,22,4,8,4,0,21,15,55,5,5,49,42,3,8,0.5,36,0.583333333333333,0
"75","Bustinza M.","LEG",1636,5,2,2,19,27,8,0,36,183,97,86,628,504,124,0,13,9,0,3,3,86,21,15,54,43,41,45,0.692307692307692,6,0.5,0
"76","Cabrera","GET",720,3,0,1,2,14,12,0,19,84,48,36,214,125,89,0,2,1,0,3,0,39,10,9,24,24,19,17,0.5,3,1,0
"77","Calleri","LPA",3111,7,9,39,75,73,30,0,24,551,298,253,710,667,42,1,77,28,3,31,33,84,16,8,121,177,113,140,0.363636363636364,64,0.484375,1
"78","Camarasa","BET",1253,2,1,2,31,19,4,2,20,145,122,23,630,583,46,1,19,4,0,11,9,72,15,5,62,60,10,13,0.210526315789474,20,0.55,0
"79","Campaña","LEV",2742,8,1,1,31,32,51,74,57,307,238,69,1569,1428,137,4,17,8,4,36,28,210,36,21,122,116,32,37,0.470588235294118,64,0.5625,1
"81","Canales","RSO",1921,4,4,0,29,23,66,101,31,220,205,15,1163,1050,107,6,44,15,5,44,22,116,25,6,104,101,2,13,0.340909090909091,66,0.666666666666667,1
"82","Capa","EIB",2247,4,0,6,9,34,95,1,57,237,196,41,1059,880,176,3,4,1,1,34,27,114,38,19,100,96,28,13,0.25,61,0.557377049180328,1
"87","Carlos Sánchez ","ESP",1123,3,0,0,14,24,1,0,25,138,99,39,581,505,76,0,2,0,0,9,1,87,12,13,47,52,27,12,0,10,0.9,0
"88","Carlos Soler","VAL",2374,4,1,1,42,54,51,4,51,295,270,25,942,876,62,4,37,17,4,26,30,135,32,19,118,152,9,16,0.459459459459459,56,0.464285714285714,1
"90","Carvajal","RMA",2223,11,0,3,32,48,90,0,59,264,217,47,1569,1449,116,4,11,6,2,32,14,155,40,19,123,94,19,28,0.545454545454545,46,0.695652173913043,1
"91","Casemiro","RMA",2601,8,5,2,72,59,7,0,109,428,325,103,1747,1541,203,3,26,12,3,11,6,243,78,31,187,138,64,39,0.461538461538462,17,0.647058823529412,1
"92","Celso Borges ","DEP",2306,3,3,4,13,35,18,0,61,373,179,194,1211,1084,126,1,22,8,3,14,3,176,39,22,86,93,118,76,0.363636363636364,17,0.823529411764706,1
"94","Charles","EIB",1580,5,8,11,29,42,7,0,11,253,105,148,413,403,10,0,39,16,1,4,6,54,8,3,42,63,73,75,0.41025641025641,10,0.4,0
"95","Cheik Doukouré","LEV",1020,4,1,0,10,34,4,0,34,145,110,35,314,297,16,1,12,1,0,1,1,71,19,15,45,65,15,20,0.0833333333333333,2,0.5,0
"96","Chema","LEV",2017,8,1,2,13,21,0,0,20,118,66,52,691,507,184,0,7,3,1,1,0,93,13,7,33,33,30,22,0.428571428571429,1,1,1
"97","Chéryshev","VIL",920,2,2,5,14,21,27,1,27,158,130,28,300,281,19,0,25,9,1,16,17,50,15,12,57,73,12,16,0.36,33,0.484848484848485,0
"98","Chichizola","LPA",2430,2,0,0,6,0,0,0,2,31,16,15,961,442,519,0,0,0,0,5,0,292,0,2,12,4,13,2,0,5,1,1
"99","Chory Castro","MGA",2075,4,4,3,28,23,108,33,37,230,190,40,822,722,98,2,22,9,2,28,23,162,24,13,93,97,21,19,0.409090909090909,51,0.549019607843137,1
"102","Clement Lenglet","SEV",3002,9,3,1,23,52,1,0,67,294,179,115,1713,1464,247,2,12,5,1,12,2,164,50,17,101,78,71,44,0.416666666666667,14,0.857142857142857,1
"103","Coke","LEV",1385,4,3,4,12,27,36,0,35,189,144,45,560,488,72,0,10,5,0,19,9,91,23,12,65,79,24,21,0.5,28,0.678571428571429,0
"104","Corchia","SEV",823,4,0,3,22,20,23,0,18,96,80,16,298,270,28,0,5,3,1,5,5,32,13,5,44,36,12,4,0.6,10,0.5,0
"105","Correa","SEV",1198,5,1,5,43,26,7,2,15,230,200,30,460,433,25,2,20,6,1,40,35,65,10,5,95,105,15,15,0.3,75,0.533333333333333,0
"106","Cote","EIB",2430,4,0,1,17,20,185,41,61,234,167,67,1104,783,321,0,11,0,8,27,11,187,44,17,104,63,37,30,0,38,0.710526315789474,1
"107","Coutinho","BAR",1303,1,8,8,32,12,14,52,27,215,204,11,813,777,26,10,28,20,5,45,31,70,14,13,104,100,5,6,0.714285714285714,76,0.592105263157895,0
"108","Cuéllar","LEG",3150,4,0,0,7,0,0,0,4,28,8,20,1028,90,938,0,0,0,0,0,0,336,3,1,7,1,16,4,0,0,0,1
"109","D. Torres","ALA",1218,2,0,0,15,23,2,0,19,116,92,24,506,440,64,2,4,2,0,9,1,88,11,8,43,49,10,14,0.5,10,0.9,0
"110","Dakonam Djené","GET",3239,7,1,1,26,51,10,0,87,350,226,124,971,725,244,2,9,2,0,30,3,245,65,22,142,84,71,53,0.222222222222222,33,0.909090909090909,1
"111","Damián Suárez","GET",2878,14,1,1,41,54,65,45,86,388,333,55,1174,919,250,5,8,5,4,34,49,188,64,22,159,174,23,32,0.625,83,0.409638554216867,1
"112","Dani Castellano","LPA",2027,5,0,4,30,17,39,0,46,232,180,52,841,777,64,0,3,0,2,24,16,109,29,17,100,80,26,26,0,40,0.6,1
"114","Dani García","EIB",2781,14,0,0,25,46,12,1,80,292,222,70,1614,1327,287,0,15,1,1,8,7,235,59,21,112,110,43,27,0.0666666666666667,15,0.533333333333333,1
"116","Dani Parejo","VAL",3005,15,7,2,67,47,40,172,87,402,364,38,2363,2065,291,7,38,21,7,46,14,300,57,30,199,165,17,21,0.552631578947368,60,0.766666666666667,1
"117","Darder","ESP",2788,7,1,0,31,36,26,23,64,281,244,37,1445,1252,186,7,18,8,2,34,14,187,43,21,129,115,16,21,0.444444444444444,48,0.708333333333333,1
"118","Darko","LEG",1201,3,2,3,20,19,8,2,32,165,126,39,403,375,27,1,9,5,0,10,12,87,17,15,62,64,19,20,0.555555555555556,22,0.454545454545455,0
"120","David García","LPA",859,2,1,0,14,11,3,0,16,72,48,24,458,378,80,0,5,3,0,5,0,46,11,5,34,14,15,9,0.6,5,1,0
"121","David Lombán","EIB",996,3,1,1,5,9,0,0,16,96,32,64,449,331,118,0,3,1,0,0,0,55,8,8,21,11,44,20,0.333333333333333,0,0,0
"122","David López","ESP",3330,6,1,2,25,45,3,0,67,295,175,120,1914,1554,359,1,13,6,0,7,5,239,49,18,95,80,65,55,0.461538461538462,12,0.583333333333333,1
"123","David Simón","LPA",718,3,0,1,11,17,29,0,24,114,94,20,406,361,44,1,3,1,0,13,13,41,17,7,48,46,7,13,0.333333333333333,26,0.5,0
"124","David Soria","SEV",1265,1,0,0,1,0,0,0,1,8,2,6,307,121,186,0,0,0,0,0,0,118,0,1,2,0,5,1,0,0,0,0
"125","De la Bella","RSO",1529,4,0,6,17,20,68,0,36,147,106,41,818,731,86,1,5,1,1,9,8,74,22,14,61,45,25,16,0.2,17,0.529411764705882,0
"126","De Marcos","ATH",1663,5,1,4,10,17,58,0,28,137,99,38,709,624,83,2,12,8,2,11,8,86,21,7,49,50,21,17,0.666666666666667,19,0.578947368421053,0
"127","Dembélé","BAR",930,2,3,3,18,10,26,27,10,162,155,7,448,428,17,3,15,10,6,40,27,37,7,3,68,87,1,6,0.666666666666667,67,0.597014925373134,0
"129","Dídac","ESP",725,3,0,1,13,14,22,2,29,97,75,22,341,292,49,0,5,3,0,6,3,43,26,3,47,28,14,8,0.6,9,0.666666666666667,0
"130","Diego Costa","ATM",1048,6,3,19,19,22,2,0,17,199,141,58,313,300,10,3,18,10,3,15,17,26,11,6,51,90,25,33,0.555555555555556,32,0.46875,0
"131","Diego González","MGA",1432,5,1,1,3,27,7,0,27,131,69,62,481,396,84,1,13,3,0,1,2,49,19,8,31,38,34,28,0.230769230769231,3,0.333333333333333,0
"132","Diego López","ESP",854,1,0,0,1,1,0,0,0,3,1,2,231,49,182,0,0,0,0,0,0,83,0,0,0,1,2,0,0,0,0,0
"133","Diego Rolan","MGA",1944,0,5,19,48,28,27,1,33,341,288,53,572,538,31,3,30,17,0,42,49,107,25,8,123,165,11,42,0.566666666666667,91,0.461538461538462,1
"135","Diop","EIB",1206,7,0,0,26,36,5,0,31,193,122,71,522,444,77,1,11,1,0,8,3,87,23,8,61,61,37,34,0.0909090909090909,11,0.727272727272727,0
"136","Dmitrovic","EIB",3240,1,0,0,5,0,0,0,4,37,21,16,1065,131,933,1,0,0,0,5,1,337,4,0,12,9,15,1,0,6,0.833333333333333,1
"138","Duarte","ALA",2141,8,0,1,35,48,54,0,76,258,206,52,655,514,141,0,4,0,2,10,5,110,40,36,118,88,28,24,0,15,0.666666666666667,1
"139","El Zhar","LEG",1981,2,2,5,35,30,58,12,11,263,218,45,565,539,26,0,30,14,2,49,44,118,6,5,94,124,14,31,0.466666666666667,93,0.526881720430108,1
"142","Emre Çolak","DEP",1452,4,1,2,24,20,44,30,24,191,173,18,792,682,101,9,15,8,1,33,15,110,19,5,80,93,2,16,0.533333333333333,48,0.6875,0
"144","Enes Ünal","VIL",1719,1,6,13,35,42,5,0,15,313,179,134,420,414,4,2,39,23,3,9,18,39,11,4,56,123,59,75,0.58974358974359,27,0.333333333333333,0
"145","Enis Bardhi","LEV",1580,9,9,3,25,39,22,42,39,224,205,19,618,546,70,2,27,13,1,23,18,93,26,13,87,118,4,15,0.481481481481481,41,0.560975609756098,0
"146","Eraso","LEG",2540,4,4,6,25,35,37,47,32,252,191,61,786,728,55,3,24,13,3,10,12,125,15,17,66,125,13,48,0.541666666666667,22,0.454545454545455,1
"147","Erick Cabaco","LEV",1039,5,0,0,12,13,0,0,25,93,58,35,324,241,83,0,2,2,0,2,2,45,13,12,38,20,20,15,1,4,0.5,0
"149","Escalante","EIB",1561,3,1,0,16,25,10,0,59,238,152,86,656,574,81,1,17,5,0,15,6,110,35,24,89,63,47,39,0.294117647058824,21,0.714285714285714,0
"150","Escudero","SEV",2332,10,0,1,38,34,40,1,78,326,230,96,1323,1184,137,2,13,4,2,26,12,156,50,28,140,90,58,38,0.307692307692308,38,0.684210526315789,1
"151","Etebo","LPA",1215,3,0,1,46,21,3,2,24,188,160,28,628,561,65,2,13,3,1,25,6,90,17,7,92,68,14,14,0.230769230769231,31,0.806451612903226,0
"153","Ezequiel Garay","VAL",2030,5,0,1,15,22,3,0,18,125,55,70,1093,945,147,1,5,1,0,0,0,101,12,6,31,24,45,25,0.2,0,0,1
"154","Fabian Schär","DEP",2220,10,2,3,22,39,1,0,59,252,169,83,944,704,236,4,17,6,2,14,6,131,45,14,93,76,45,38,0.352941176470588,20,0.7,1
"155","Fabián","BET",2662,3,3,2,35,27,14,2,83,373,330,43,2083,1929,148,6,27,17,6,69,22,252,53,30,186,144,26,17,0.62962962962963,91,0.758241758241758,1
"156","Facundo Roncaglia","CEL",1492,2,0,1,8,15,6,0,35,130,88,42,1070,900,168,2,5,1,0,9,0,112,25,10,52,36,23,19,0.2,9,1,0
"158","Fajr ","GET",2383,6,1,1,37,46,85,55,61,287,235,52,933,697,233,3,17,10,4,19,8,178,44,17,114,121,25,27,0.588235294117647,27,0.703703703703704,1
"159","Feddal","BET",1257,7,3,1,16,20,3,0,22,113,68,45,812,634,178,0,5,3,0,3,0,73,14,8,40,28,28,17,0.6,3,1,0
"160","Fede Cartabia","DEP",1332,6,2,4,47,23,39,16,36,235,205,30,525,482,40,3,24,9,1,35,17,93,23,13,117,88,5,25,0.375,52,0.673076923076923,0
"161","Fede Valverde","DEP",1229,0,0,1,3,14,12,4,25,96,67,29,576,506,68,2,14,4,0,7,6,81,16,9,35,32,15,14,0.285714285714286,13,0.538461538461538,0
"162","Fernando Navarro","DEP",1042,5,0,0,12,19,12,0,32,115,82,33,442,375,67,0,0,0,0,8,0,52,22,10,52,30,18,15,0,8,1,0
"163","Fernando Torres","ATM",966,2,5,10,23,17,2,0,11,198,106,92,241,226,13,2,25,13,0,17,17,35,8,3,47,59,50,42,0.52,34,0.5,0
"165","Filipe Luis","ATM",1660,4,1,1,27,16,43,1,83,223,194,29,948,868,80,0,5,2,2,26,18,111,52,31,135,59,18,11,0.4,44,0.590909090909091,0
"166","Fontàs","CEL",884,2,0,0,0,7,0,0,13,56,32,24,722,618,103,1,1,0,1,0,0,51,9,4,13,19,10,14,0,0,0,0
"169","Franco Vázquez","SEV",1845,4,4,9,61,47,32,1,39,354,283,71,862,806,46,10,42,13,6,32,24,119,32,7,127,156,38,33,0.30952380952381,56,0.571428571428571,0
"170","G. Cabral","CEL",1890,5,1,2,4,14,0,0,29,169,73,96,1278,1112,166,0,7,2,1,1,0,109,21,8,32,41,58,38,0.285714285714286,1,1,0
"171","Gabi","ATM",2346,8,0,1,23,51,18,29,80,286,249,37,1721,1515,202,4,7,1,1,10,5,235,49,31,111,138,19,18,0.142857142857143,15,0.666666666666667,1
"172","Gabriel Mercado","SEV",2122,9,0,6,16,36,23,0,55,217,139,78,956,842,113,1,14,7,1,4,3,118,37,18,73,66,41,37,0.5,7,0.571428571428571,1
"173","Gabriel","LEG",2383,6,5,1,51,56,14,0,89,569,368,201,1169,1028,135,6,33,15,2,49,29,208,69,20,187,181,112,89,0.454545454545455,78,0.628205128205128,1
"174","Gabriel","VAL",2584,5,0,0,19,23,1,0,47,192,99,93,1365,1201,163,1,15,4,0,5,0,166,27,20,66,33,64,29,0.266666666666667,5,1,1
"175","Gaku Shibasaki","GET",1003,1,1,5,13,27,19,15,21,146,109,37,328,293,31,4,7,3,0,12,5,58,10,11,46,63,6,31,0.428571428571429,17,0.705882352941177,0
"176","Gálvez","LPA",1979,6,1,5,20,36,2,0,60,245,158,87,1146,905,241,0,16,5,0,10,2,166,39,21,88,70,53,34,0.3125,12,0.833333333333333,1
"177","Gameiro","ATM",1119,0,7,12,9,9,2,0,11,108,71,37,230,228,2,0,16,14,2,9,6,30,9,2,29,42,9,28,0.875,15,0.6,0
"179","Gayá","VAL",2917,11,0,5,45,35,94,0,77,314,261,53,1353,1208,143,2,11,3,3,38,24,176,60,17,160,101,24,29,0.272727272727273,62,0.612903225806452,1
"181","Gerard","ESP",3413,4,16,36,78,56,39,0,41,697,394,303,1198,1076,112,10,85,48,1,63,50,146,28,13,176,218,138,165,0.564705882352941,113,0.557522123893805,1
"182","Giménez","ATM",1684,6,1,2,18,15,2,0,38,179,90,89,736,567,169,0,12,2,1,6,2,107,27,11,61,29,58,31,0.166666666666667,8,0.75,0
"183","Godín","ATM",2554,6,0,5,26,46,0,0,50,235,140,95,1211,1007,203,1,12,5,0,6,1,135,33,17,79,61,57,38,0.416666666666667,7,0.857142857142857,1
"184","Gonçalo Guedes","VAL",2441,2,5,10,70,35,49,6,38,375,349,26,892,825,58,9,42,22,9,81,48,133,26,12,187,162,11,15,0.523809523809524,129,0.627906976744186,1
"185","Granell","GIR",2853,10,1,0,39,70,110,90,78,399,350,49,1672,1349,320,3,32,8,7,48,8,230,53,25,165,185,24,25,0.25,56,0.857142857142857,1
"186","Granero","ESP",1222,5,1,1,21,19,24,39,32,165,127,38,690,626,63,1,12,2,2,9,8,85,22,10,62,65,13,25,0.166666666666667,17,0.529411764705882,0
"187","Griezmann","ATM",2529,6,19,26,44,24,26,18,36,284,198,86,1028,942,73,13,61,40,9,28,18,120,24,12,107,91,26,60,0.655737704918033,46,0.608695652173913,1
"188","Guaita","GET",2970,1,0,0,4,0,0,0,0,18,3,15,925,106,819,0,0,0,0,0,0,330,0,0,3,0,14,1,0,0,0,1
"189","Guardado","BET",2266,7,2,2,39,31,56,43,41,257,220,37,1461,1301,148,12,30,9,8,22,11,166,27,14,101,119,18,19,0.3,33,0.666666666666667,1
"190","Guidetti","ALA",1338,3,3,11,16,33,13,1,7,178,97,81,385,361,20,4,29,14,3,8,4,44,7,0,29,68,33,48,0.482758620689655,12,0.666666666666667,0
"191","Guido Pizarro","SEV",1754,9,1,0,26,48,0,0,75,304,231,73,1247,1171,75,1,9,4,0,21,10,124,47,28,122,109,47,26,0.444444444444444,31,0.67741935483871,0
"192","Guilherme ","DEP",2643,11,0,0,46,56,18,20,80,351,275,76,1407,1238,167,2,29,2,0,26,9,212,56,24,151,124,39,37,0.0689655172413793,35,0.742857142857143,1
"193","Guillermo Maripán","ALA",1527,4,0,0,4,15,0,0,28,130,72,58,458,372,84,2,3,1,0,10,1,69,16,12,42,30,29,29,0.333333333333333,11,0.909090909090909,0
"194","Gumbau","LEG",1431,8,1,1,6,40,1,1,35,160,120,40,522,426,94,2,12,6,0,6,1,90,26,9,47,73,20,20,0.5,7,0.857142857142857,0
"195","H.Moreno","RSO",720,1,1,1,13,9,0,0,7,66,26,40,502,421,80,1,8,4,0,0,0,55,3,4,17,9,27,13,0.5,0,0,0
"196","Halilovic","LPA",1306,1,2,1,25,9,58,26,11,140,123,17,445,415,30,0,29,15,1,31,19,61,7,4,67,56,3,14,0.517241379310345,50,0.62,0
"198","Hermoso","ESP",1929,5,1,1,15,19,0,2,15,158,70,88,955,661,294,0,10,4,0,5,3,116,12,3,33,37,52,36,0.4,8,0.625,1
"202","Hugo Mallo","CEL",3004,12,0,5,27,48,113,2,84,335,222,113,1745,1470,274,1,18,8,5,19,15,168,55,29,129,93,64,49,0.444444444444444,34,0.558823529411765,1
"203","I. Martínez","ATH",2496,5,1,3,35,30,19,0,42,264,137,127,1469,1143,322,4,14,5,1,11,2,188,29,13,86,51,71,56,0.357142857142857,13,0.846153846153846,1
"204","Iago Aspas","CEL",2937,9,22,11,62,23,52,29,26,330,274,56,1234,1152,73,9,72,44,5,58,34,138,22,4,145,129,16,40,0.611111111111111,92,0.630434782608696,1
"205","Iago Herrerín","ATH",720,0,0,0,2,2,0,0,2,10,6,4,260,47,213,0,0,0,0,0,0,66,1,1,4,2,3,1,0,0,0,0
"206","Ibai","ALA",2324,1,7,8,19,17,78,79,19,233,211,22,818,701,110,7,39,24,6,38,42,144,15,4,76,135,8,14,0.615384615384615,80,0.475,1
"207","Ideye","MGA",731,2,1,8,14,12,1,0,2,123,60,63,158,152,6,0,9,3,0,5,7,18,2,0,20,40,23,40,0.333333333333333,12,0.416666666666667,0
"208","Igor Zubeldia","RSO",1578,3,1,1,15,19,2,0,39,184,122,62,940,832,106,2,12,3,2,9,1,115,29,10,63,59,38,24,0.25,10,0.9,0
"209","Illarramendi","RSO",3163,8,7,0,67,34,43,7,85,339,297,42,2516,2292,217,7,26,11,5,30,9,285,57,28,180,117,25,17,0.423076923076923,39,0.769230769230769,1
"211","Iniesta","BAR",1842,1,1,0,40,15,23,1,28,220,211,9,1520,1375,131,14,13,6,2,63,14,123,22,6,131,80,2,7,0.461538461538462,77,0.818181818181818,0
"212","Inui","EIB",2640,4,5,5,49,40,58,12,39,339,294,45,841,779,58,4,43,21,2,40,47,127,21,18,128,166,13,32,0.488372093023256,87,0.459770114942529,1
"213","Iñigo Lekue","ATH",2104,3,0,1,12,25,72,0,71,276,218,58,949,833,116,0,14,5,1,43,32,136,42,29,126,92,27,31,0.357142857142857,75,0.573333333333333,1
"214","Iraizoz","GIR",765,1,0,0,0,0,0,0,1,3,2,1,201,33,168,0,0,0,0,0,0,89,1,0,1,1,0,1,0,0,0,0
"215","Isco","RMA",1778,1,7,6,59,19,71,51,22,276,257,19,1521,1424,87,10,32,20,7,58,25,89,12,10,137,120,5,14,0.625,83,0.698795180722892,0
"216","Iturra","MGA",1583,6,0,0,21,43,8,1,70,260,215,45,587,504,82,1,2,1,0,19,7,122,45,25,110,105,22,23,0.5,26,0.730769230769231,0
"217","Iturraspe","ATH",1903,7,0,0,22,29,34,41,42,203,130,73,1190,1026,161,3,5,1,0,5,1,176,31,11,68,62,42,31,0.2,6,0.833333333333333,1
"218","Iván Alejo","EIB",1105,5,1,3,45,25,109,1,20,212,185,27,218,205,12,1,9,3,3,33,39,67,16,4,95,90,13,14,0.333333333333333,72,0.458333333333333,0
"220","Ivi","LEV",1759,3,4,4,20,40,73,34,48,301,270,31,562,473,84,5,27,10,3,33,31,95,34,14,100,170,11,20,0.37037037037037,64,0.515625,0
"221","J. Costa","VIL",2541,13,0,0,37,54,67,1,68,298,225,73,1300,1154,145,1,9,3,0,26,12,122,44,24,130,95,34,39,0.333333333333333,38,0.684210526315789,1
"226","Jason","LEV",1792,2,1,5,29,31,51,14,32,268,221,47,501,472,24,5,23,10,2,25,46,95,25,7,84,137,18,29,0.434782608695652,71,0.352112676056338,0
"229","Javi Castellano","LPA",1565,4,0,0,26,14,3,0,47,176,117,59,1078,1010,68,0,3,2,0,7,5,91,27,20,78,39,29,30,0.666666666666667,12,0.583333333333333,0
"230","Javi Fuego","VIL",1880,8,0,0,34,37,1,0,53,239,168,71,950,857,92,1,4,2,0,5,3,119,36,17,89,79,38,33,0.5,8,0.625,0
"231","Javi García","BET",2410,6,1,1,33,33,0,0,34,241,161,80,1676,1574,102,0,7,1,0,13,4,141,22,12,79,82,48,32,0.142857142857143,17,0.764705882352941,1
"232","Javi López","ESP",967,4,0,0,20,20,28,0,47,154,121,33,440,384,56,0,2,0,0,7,7,55,35,12,71,50,18,15,0,14,0.5,0
"233","Jefferson Lerma","LEV",2137,16,0,0,51,55,2,0,52,346,210,136,1092,990,98,4,18,1,1,19,3,188,36,16,118,92,88,48,0.0555555555555556,22,0.863636363636364,1
"234","Jesús Navas","SEV",1762,2,1,8,24,16,93,2,32,164,128,36,782,700,80,2,16,5,0,16,12,106,25,7,71,57,12,24,0.3125,28,0.571428571428571,0
"236","Joan Jordán","EIB",2422,1,6,5,17,37,53,66,31,317,245,72,1181,1034,144,3,30,17,4,42,22,176,24,7,89,156,37,35,0.566666666666667,64,0.65625,1
"237","Joaquín","BET",2487,7,4,5,40,21,56,60,22,274,226,48,1233,1128,96,9,27,14,7,64,29,131,19,3,125,101,18,30,0.518518518518518,93,0.688172043010753,1
"241","Jonny","CEL",3203,10,2,1,37,50,51,0,102,415,344,71,1743,1594,144,5,8,4,1,46,28,213,78,24,183,161,37,34,0.5,74,0.621621621621622,1
"243","Jordi Alba","BAR",2744,8,2,16,21,35,46,1,63,227,191,36,2102,2000,100,2,11,5,8,23,10,189,42,21,107,84,15,21,0.454545454545455,33,0.696969696969697,1
"244","Jordi Amat","BET",2051,6,0,0,10,38,0,0,32,175,115,60,1598,1442,156,0,3,1,0,18,4,112,23,9,59,56,30,30,0.333333333333333,22,0.818181818181818,1
"245","Jorge Molina","GET",2790,10,7,39,61,54,17,0,18,532,272,260,834,796,29,9,54,26,4,23,43,88,10,8,93,179,106,154,0.481481481481481,66,0.348484848484849,1
"248","Jozabed","CEL",1483,7,0,2,10,14,6,2,18,96,82,14,876,786,85,5,16,5,4,6,4,126,12,6,34,48,5,9,0.3125,10,0.6,0
"250","Juanfran","ATM",1308,3,0,5,9,32,36,0,33,127,112,15,504,476,27,1,1,0,1,7,7,76,24,9,49,63,5,10,0,14,0.5,0
"251","Juanfran","DEP",3058,3,0,1,32,24,160,2,64,314,241,73,1405,1213,191,1,16,7,1,47,25,201,44,20,140,101,42,31,0.4375,72,0.652777777777778,1
"253","Juankar","MGA",784,2,0,1,8,9,24,0,23,78,61,17,316,276,39,1,0,0,0,6,5,51,17,6,36,25,6,11,0,11,0.545454545454545,0
"254","Juanmi","RSO",1490,3,8,16,23,20,5,0,22,159,130,29,348,332,16,0,28,13,2,11,16,57,13,9,56,74,11,18,0.464285714285714,27,0.407407407407407,0
"255","Juanpe","GIR",3064,7,5,1,7,48,4,0,48,215,120,95,1335,999,336,0,17,11,1,4,0,108,30,18,58,62,61,34,0.647058823529412,4,1,1
"258","Juncà","EIB",902,3,0,0,7,14,63,8,15,73,62,11,463,381,81,1,3,0,2,10,3,58,13,2,32,30,5,6,0,13,0.769230769230769,0
"259","Jurado","ESP",1506,1,0,0,34,6,23,1,18,156,151,5,607,559,46,2,9,2,3,35,23,116,14,4,87,64,2,3,0.222222222222222,58,0.603448275862069,0
"260","Keko","MGA",1217,3,0,6,28,35,41,0,38,204,180,24,343,317,26,0,11,5,2,10,8,88,23,15,76,104,14,10,0.454545454545455,18,0.555555555555556,0
"261","Kepa","ATH",2700,4,0,0,7,1,0,0,0,17,7,10,937,223,714,0,0,0,0,0,0,253,0,0,4,3,9,1,0,0,0,1
"262","Kévin Rodrigues","RSO",1633,2,1,0,15,23,70,1,44,171,132,39,702,661,41,0,10,3,2,14,10,100,32,12,72,60,20,19,0.3,24,0.583333333333333,0
"264","Keylor Navas","RMA",2430,1,0,0,3,1,0,0,2,11,7,4,570,332,238,0,0,0,0,0,0,201,1,1,5,2,4,0,0,0,0,1
"265","Kike","EIB",2464,5,8,13,76,47,15,0,14,439,196,243,688,666,22,0,55,27,1,13,17,101,8,6,91,105,107,136,0.490909090909091,30,0.433333333333333,1
"266","Kiko Casilla","RMA",900,0,0,0,0,0,0,0,1,3,1,2,219,125,94,0,0,0,0,0,0,78,0,1,1,0,2,0,0,0,0,0
"267","Koke","ATM",2762,3,4,1,51,24,62,97,75,326,299,27,1989,1777,197,15,21,14,4,20,7,232,45,30,142,157,17,10,0.666666666666667,27,0.740740740740741,1
"268","Kondogbia","VAL",2617,11,4,1,53,57,3,0,88,440,357,83,1548,1372,172,4,19,8,4,55,9,231,57,31,192,165,45,38,0.421052631578947,64,0.859375,1
"269","Kovacic","RMA",988,2,0,0,20,10,4,1,38,145,137,8,791,741,49,1,6,2,1,33,4,78,27,11,91,46,1,7,0.333333333333333,37,0.891891891891892,0
"270","Krohn-Dehli","DEP",1266,2,1,2,5,12,12,19,25,112,93,19,700,646,52,2,11,3,1,15,3,91,16,9,45,48,5,14,0.272727272727273,18,0.833333333333333,0
"271","Lacen","MGA",1121,3,0,0,11,20,8,0,38,143,113,30,502,448,54,0,5,1,0,5,3,83,20,18,54,59,17,13,0.2,8,0.625,0
"272","Laguardia","ALA",1530,3,2,0,5,10,2,0,20,109,42,67,558,374,184,0,5,2,0,1,0,75,15,5,26,16,45,22,0.4,1,1,0
"273","Lato","VAL",798,4,0,1,8,10,10,0,30,94,74,20,329,292,37,0,1,0,1,8,1,55,16,14,45,29,9,11,0,9,0.888888888888889,0
"274","Léo Baptistão","ESP",2686,4,8,14,49,48,34,0,54,412,302,110,686,655,26,5,63,28,3,30,50,128,34,20,131,171,48,62,0.444444444444444,80,0.375,1
"275","Llorente R.","RSO",2328,8,3,0,27,35,3,0,30,242,122,120,1521,1314,207,0,21,7,0,16,2,148,22,8,71,51,64,56,0.333333333333333,18,0.888888888888889,1
"276","Lobotka","CEL",3061,2,0,0,47,42,10,0,64,332,272,60,2069,1902,165,2,6,3,0,44,4,289,45,19,155,117,26,34,0.5,48,0.916666666666667,1
"277","Loïc Remy","GET",1219,3,8,12,19,22,12,0,8,158,104,54,349,327,21,1,35,22,0,27,12,33,5,3,54,50,26,28,0.628571428571429,39,0.692307692307692,0
"278","Loren","BET",1064,3,7,5,28,26,4,0,14,186,139,47,189,177,9,3,20,14,0,19,14,28,8,6,60,79,14,33,0.7,33,0.575757575757576,0
"281","Lucas Digne","BAR",702,2,0,2,7,12,15,0,22,69,51,18,480,462,18,0,2,1,2,3,3,58,17,5,32,19,9,9,0.5,6,0.5,0
"282","Lucas Hernández","ATM",2116,6,0,4,46,31,17,0,93,312,233,79,916,816,99,1,5,1,1,30,8,134,68,25,166,67,44,35,0.2,38,0.789473684210526,1
"283","Lucas Pérez","DEP",2796,3,8,37,33,25,81,111,17,235,214,21,808,736,65,7,41,26,6,32,38,112,12,5,80,134,6,15,0.634146341463415,70,0.457142857142857,1
"284","Lucas Vázquez","RMA",1668,3,4,12,42,33,78,20,48,282,260,22,894,849,44,1,25,17,7,36,30,85,33,15,126,134,5,17,0.68,66,0.545454545454545,0
"285","Luis H. ","MGA",3240,7,0,3,10,42,8,0,49,210,119,91,1413,1117,295,1,3,0,1,3,0,190,43,6,62,57,48,43,0,3,1,1
"286","Luis Muriel","SEV",1603,4,7,31,13,26,17,2,16,241,166,75,421,410,7,4,45,21,1,28,30,41,9,7,57,109,26,49,0.466666666666667,58,0.482758620689655,0
"287","Luis Suárez","BAR",2899,8,25,56,50,46,12,1,17,288,266,22,1055,977,67,11,94,56,12,38,64,50,10,7,103,163,13,9,0.595744680851064,102,0.372549019607843,1
"288","Luisinho","DEP",2622,11,1,2,49,43,88,0,111,350,308,42,1182,1012,169,1,11,4,1,43,18,157,77,34,203,105,19,23,0.363636363636364,61,0.704918032786885,1
"289","M. Gómez","CEL",3077,12,17,32,92,54,16,0,7,414,221,193,630,589,40,1,61,38,4,14,15,68,4,3,107,114,89,104,0.622950819672131,29,0.482758620689655,1
"290","M. Guerrero","LEG",1438,3,4,13,23,36,1,0,7,198,114,84,370,362,7,1,27,12,3,9,13,37,5,2,39,75,42,42,0.444444444444444,22,0.409090909090909,0
"291","M. M. Dos Santos","LEG",981,3,0,2,3,9,3,0,16,72,38,34,308,240,68,0,1,1,0,1,1,35,14,2,20,18,21,13,1,2,0.5,0
"292","M. Navarro","ESP",1105,3,1,0,8,12,61,0,20,122,88,34,392,331,60,1,14,5,0,9,20,59,13,7,36,52,12,22,0.357142857142857,29,0.310344827586207,0
"293","M. Trigueros","VIL",2709,9,3,1,43,38,52,53,61,323,271,52,1816,1630,177,9,24,8,4,33,13,213,41,20,136,135,28,24,0.333333333333333,46,0.717391304347826,1
"295","Mantovani","LEG",1019,3,1,0,15,17,0,0,12,106,45,61,377,319,58,0,5,1,0,2,0,45,5,7,28,17,36,25,0.2,2,1,0
"296","Manu García","ALA",2438,9,3,5,72,65,12,0,97,475,342,133,984,857,125,2,21,8,0,18,9,182,66,31,181,161,75,58,0.380952380952381,27,0.666666666666667,1
"298","Marcelo","RMA",2262,3,2,3,41,26,154,11,53,269,234,35,1608,1424,180,4,25,9,6,33,29,159,37,16,127,107,9,26,0.36,62,0.532258064516129,1
"299","Marco Asensio","RMA",1839,2,6,2,27,9,75,50,26,154,148,6,1133,1077,47,9,40,23,6,31,14,78,17,9,84,64,3,3,0.575,45,0.688888888888889,0
"301","Mario Gaspar","VIL",2805,6,2,3,15,44,60,0,109,353,257,96,1441,1287,153,1,23,10,3,22,24,157,67,42,144,113,59,37,0.434782608695652,46,0.478260869565217,1
"302","Markel Bergara","GET",1469,5,4,2,18,34,5,0,34,169,108,61,385,359,26,0,14,9,1,2,0,80,21,13,52,56,30,31,0.642857142857143,2,1,0
"305","Matías Aguirregaray","LPA",1155,3,0,1,21,19,19,0,25,151,120,31,549,472,75,2,6,0,0,14,9,87,20,5,60,60,14,17,0,23,0.608695652173913,0
"306","Mauro Arambarri","GET",2135,8,1,0,42,50,6,0,56,279,230,49,618,468,147,3,13,3,1,13,11,166,41,15,110,120,18,31,0.230769230769231,24,0.541666666666667,1
"307","Maxime Lestienne","MGA",671,1,0,1,3,3,26,8,8,57,52,5,200,183,17,0,11,1,1,10,8,37,5,3,21,31,0,5,0.0909090909090909,18,0.555555555555556,0
"309","Melendo","ESP",680,1,0,0,21,6,5,2,2,67,52,15,257,236,19,2,5,2,1,8,7,38,2,0,30,22,4,11,0.4,15,0.533333333333333,0
"310","Messi","BAR",2996,3,34,13,80,17,26,44,17,512,493,19,1883,1735,111,37,153,96,12,185,72,86,8,9,282,211,8,11,0.627450980392157,257,0.719844357976654,1
"311","Michel Macedo","LPA",2136,4,0,6,43,38,65,0,33,223,160,63,914,841,71,2,6,3,1,14,8,124,24,9,88,72,34,29,0.5,22,0.636363636363636,1
"313","Miguel Layún","SEV",1181,4,2,0,9,12,44,11,28,107,81,26,511,436,74,1,15,5,0,8,3,64,19,9,44,37,15,11,0.333333333333333,11,0.727272727272727,0
"314","Miguel Torres","MGA",675,3,0,2,0,8,4,0,16,45,33,12,251,213,38,0,1,0,0,0,1,36,13,3,16,17,5,7,0,1,0,0
"315","Mikel Oyarzabal","RSO",2779,4,12,17,46,28,32,60,33,367,286,81,907,852,53,2,49,32,5,40,42,111,23,10,118,168,33,48,0.653061224489796,82,0.48780487804878,1
"316","Mikel Rico","ATH",1170,2,0,0,23,19,11,1,24,138,120,18,535,478,56,1,11,1,0,10,8,125,13,11,57,63,6,12,0.0909090909090909,18,0.555555555555556,0
"317","Miquel","MGA",1775,5,0,0,14,41,2,0,19,188,95,93,692,506,185,1,8,1,0,10,2,87,10,9,42,53,45,48,0.125,12,0.833333333333333,0
"318","Modric","RMA",1976,3,1,0,31,20,14,6,33,212,193,19,1547,1378,158,11,26,8,6,48,15,149,22,11,112,81,7,12,0.307692307692308,63,0.761904761904762,1
"319","Mojica","GIR",2132,6,0,6,47,38,147,1,42,341,278,63,774,696,77,1,11,2,4,47,69,161,27,15,135,143,27,36,0.181818181818182,116,0.405172413793103,1
"321","Momo","LPA",674,3,0,3,21,5,24,12,14,81,69,12,356,325,29,2,4,1,1,7,4,44,8,6,42,27,4,8,0.25,11,0.636363636363636,0
"322","Montoya","VAL",2152,7,0,1,28,38,51,1,66,257,198,59,984,892,92,0,5,5,4,19,14,98,48,18,112,86,34,25,1,33,0.575757575757576,1
"323","Morales","LEV",3065,6,10,9,43,28,133,18,37,462,417,45,792,716,68,8,45,25,8,91,93,181,23,14,168,249,13,32,0.555555555555556,184,0.494565217391304,1
"324","Moyà","RSO",765,0,0,0,0,1,0,0,0,4,2,2,337,152,185,0,0,0,0,0,0,86,0,0,0,2,2,0,0,0,0,0
"326","Muniain ","ATH",775,1,4,1,29,5,10,5,10,112,107,5,429,392,32,5,16,10,2,22,14,45,8,2,61,46,2,3,0.625,36,0.611111111111111,0
"327","Muniesa","GIR",1129,3,0,0,9,12,1,0,33,118,75,43,630,524,106,0,2,1,1,5,2,69,18,15,47,28,24,19,0.5,7,0.714285714285714,0
"328","Munir","ALA",2456,7,10,45,114,33,49,35,25,412,311,101,627,593,31,3,51,23,6,28,22,83,20,5,162,149,38,63,0.450980392156863,50,0.56,1
"329","Muñoz","LEG",1407,2,0,2,6,18,1,0,36,131,67,64,495,419,76,0,5,2,1,3,0,79,28,8,43,24,38,26,0.4,3,1,0
"330","Murillo","VAL",1374,4,0,2,15,16,0,0,31,143,71,72,751,654,96,1,1,0,0,3,0,85,24,7,48,23,46,26,0,3,1,0
"331","N'Zonzi","SEV",2215,2,1,2,13,31,10,0,39,243,118,125,1850,1763,87,0,15,5,2,13,3,186,26,13,63,55,102,23,0.333333333333333,16,0.8125,1
"332","N. Semedo","BAR",1495,1,0,3,21,12,15,0,34,164,150,14,978,917,60,1,3,2,0,28,18,103,25,9,83,67,7,7,0.666666666666667,46,0.608695652173913,0
"333","Nacho Gil","LPA",958,1,0,2,33,20,12,36,16,142,123,19,333,318,15,0,4,3,1,10,11,43,7,9,58,65,9,10,0.75,21,0.476190476190476,0
"334","Nacho","RMA",2073,7,3,0,28,33,24,0,55,207,142,65,1109,1033,75,1,8,4,0,6,4,125,40,15,85,57,38,27,0.5,10,0.6,1
"336","Naldo","ESP",922,2,0,1,0,7,0,0,14,72,28,44,432,370,62,0,1,0,0,2,0,45,8,6,16,12,24,20,0,2,1,0
"339","Neto","VAL",2970,2,0,0,4,0,0,0,1,12,5,7,668,167,501,0,1,0,0,0,0,242,1,0,4,1,7,0,0,0,0,1
"340","Nolito","SEV",1599,4,4,20,24,17,17,20,49,236,203,33,606,554,43,9,33,18,5,27,27,97,36,13,100,103,13,20,0.545454545454545,54,0.5,0
"341","O. Duarte","ESP",990,1,0,0,6,8,1,0,12,81,32,49,481,363,118,0,2,0,0,1,0,33,9,3,17,15,34,15,0,1,1,0
"342","Oblak ","ATM",3330,1,0,0,3,2,0,0,0,13,7,6,799,187,612,0,0,0,0,3,0,284,0,0,5,2,5,1,0,3,1,1
"343","Oier","LEV",2340,2,0,0,4,2,0,0,0,15,9,6,648,120,528,0,0,0,0,2,0,241,0,0,5,4,5,1,0,2,1,1
"345","Omar R.","LEG",1457,3,0,2,18,14,56,24,22,202,167,35,426,377,46,3,6,2,1,33,26,75,14,8,73,94,15,20,0.333333333333333,59,0.559322033898305,0
"346","Orellana","EIB",1182,4,3,5,20,15,39,23,14,244,206,38,469,430,38,1,19,5,2,33,60,82,8,6,67,139,12,26,0.263157894736842,93,0.354838709677419,0
"347","P. Hernández ","CEL",1812,5,3,8,62,54,7,0,48,378,240,138,1230,1088,138,4,14,3,2,18,9,166,33,15,123,117,82,56,0.214285714285714,27,0.666666666666667,0
"348","P. León","EIB",929,1,0,3,10,12,67,68,9,108,79,29,286,257,29,0,17,8,3,18,14,36,4,5,37,42,10,19,0.470588235294118,32,0.5625,0
"349","P. Mosquera","DEP",1397,7,0,0,12,32,11,0,48,204,147,57,707,581,125,1,9,3,2,9,4,114,31,17,69,78,23,34,0.333333333333333,13,0.692307692307692,0
"350","Pablo Fornals","VIL",2622,4,3,2,32,34,23,9,52,313,248,65,1326,1190,119,17,33,14,12,26,26,195,33,19,109,139,29,36,0.424242424242424,52,0.5,1
"351","Pablo Maffeo","GIR",2650,11,0,1,35,30,112,2,74,356,258,98,851,734,116,1,20,7,1,33,28,165,55,19,139,119,62,36,0.35,61,0.540983606557377,1
"352","Pablo Sarabia","SEV",2398,7,6,20,41,46,77,45,27,280,237,43,1008,946,54,8,42,27,5,21,24,133,19,8,87,150,14,29,0.642857142857143,45,0.466666666666667,1
"353","Pacheco","ALA",3357,2,0,0,3,0,0,0,0,8,2,6,952,141,811,0,0,0,0,1,0,297,0,0,2,0,6,0,0,1,1,1
"356","Pau López","ESP",2566,3,0,0,5,0,0,0,0,13,4,9,682,152,530,0,0,0,0,0,0,259,0,0,4,0,8,1,0,0,0,1
"357","Paulinho","BAR",1939,2,9,4,33,32,3,0,39,268,200,68,1219,1177,39,3,38,22,2,25,18,112,28,11,96,104,30,38,0.578947368421053,43,0.581395348837209,1
"358","Paulo","EIB",2215,3,0,0,12,15,1,0,41,209,76,133,888,662,225,1,10,3,0,2,0,115,22,19,54,22,71,62,0.3,2,1,1
"360","Pedraza","ALA",2441,5,3,5,22,46,76,1,56,335,289,46,595,541,53,1,29,13,5,43,55,131,40,16,121,168,20,26,0.448275862068966,98,0.438775510204082,1
"361","Pedro López","LEV",1596,4,0,4,29,19,53,0,33,154,122,32,576,504,72,0,2,0,0,7,15,89,23,10,68,54,9,23,0,22,0.318181818181818,0
"363","Peñaranda","MGA",807,3,0,3,27,28,5,0,10,189,125,64,242,236,6,0,17,6,0,15,14,41,6,4,52,73,17,47,0.352941176470588,29,0.517241379310345,0
"364","Pere Pons","GIR",2564,8,0,0,35,59,3,0,80,391,323,68,1025,932,89,4,9,4,2,41,16,176,54,26,156,167,24,44,0.444444444444444,57,0.719298245614035,1
"365","Piatti","ESP",1747,0,2,7,52,35,84,63,45,320,251,69,521,487,33,1,21,6,3,24,25,107,32,13,121,130,23,46,0.285714285714286,49,0.489795918367347,0
"366","Piqué","BAR",2633,9,2,3,11,23,2,0,31,203,109,94,1852,1634,218,0,13,5,0,13,3,206,22,9,54,55,65,29,0.384615384615385,16,0.8125,1
"368","Portillo","GET",2465,6,2,2,29,27,26,8,39,311,256,55,970,886,69,15,12,8,3,36,40,173,24,15,102,154,14,41,0.666666666666667,76,0.473684210526316,1
"369","Portu","GIR",3010,5,11,23,55,54,72,0,30,448,348,100,587,564,18,5,41,25,5,50,68,140,24,6,131,217,21,79,0.609756097560976,118,0.423728813559322,1
"370","Postigo","LEV",2426,6,1,0,15,12,3,0,36,152,89,63,952,739,211,2,4,2,0,9,2,113,23,13,58,31,26,37,0.5,11,0.818181818181818,1
"371","R. Albentosa","DEP",1749,5,1,1,14,15,2,0,13,115,56,59,769,591,177,1,10,2,0,2,1,73,6,7,27,29,41,18,0.2,3,0.666666666666667,0
"372","Radoja","CEL",1097,3,0,1,15,11,4,0,18,112,78,34,606,576,30,0,4,2,1,11,5,64,16,2,44,34,19,15,0.5,16,0.6875,0
"374","Rakitic","BAR",2838,4,1,3,46,33,18,49,52,268,219,49,2495,2285,199,11,20,11,5,26,8,232,31,21,123,96,25,24,0.55,34,0.764705882352941,1
"375","Ramalho","GIR",2297,3,0,1,12,20,7,0,25,151,85,66,877,689,188,0,6,1,0,13,3,135,16,9,49,36,39,27,0.166666666666667,16,0.8125,1
"376","Ramis ","EIB",1303,4,3,2,8,11,1,0,20,140,53,87,696,539,157,0,10,7,0,4,0,107,14,6,29,24,56,31,0.7,4,1,0
"377","Raúl C.","LEG",1388,1,0,0,17,10,58,17,34,128,99,29,476,394,81,1,7,1,2,11,8,94,25,9,62,37,13,16,0.142857142857143,19,0.578947368421053,0
"378","Raúl García","ATH",2637,10,10,16,74,79,40,0,81,543,319,224,847,759,79,9,68,34,1,12,8,121,50,31,158,161,130,94,0.5,20,0.6,1
"379","Raúl Lizoain","LPA",990,0,0,0,3,0,0,0,1,7,7,0,318,180,138,0,0,0,0,0,0,99,0,1,5,2,0,0,0,0,0,0
"380","Raúl Navas","RSO",1792,4,0,0,6,13,1,0,22,126,63,63,1218,1012,204,2,11,2,1,6,0,120,15,7,34,29,40,23,0.181818181818182,6,1,0
"381","Recio","MGA",1841,9,1,1,44,42,33,40,54,279,234,45,952,850,97,5,17,4,2,17,11,145,42,12,114,120,22,23,0.235294117647059,28,0.607142857142857,0
"382","Ricca","MGA",1111,4,0,0,6,18,32,0,43,129,85,44,434,354,80,0,4,3,1,7,1,50,24,19,56,29,26,18,0.75,8,0.875,0
"383","Rico","LEG",2228,8,2,4,43,37,103,26,68,268,217,51,924,775,149,0,17,8,2,20,15,183,43,25,128,89,30,21,0.470588235294118,35,0.571428571428571,1
"386","Riza Durmisi","BET",2080,4,2,2,10,15,66,3,39,118,95,23,825,746,78,1,13,6,3,8,12,89,21,18,57,38,6,17,0.461538461538462,20,0.4,1
"387","Róber","LEV",1904,4,0,0,7,17,3,0,35,132,89,43,671,566,105,0,6,1,0,8,0,125,22,13,48,41,18,25,0.166666666666667,8,1,1
"388","Roberto Rosales ","MGA",3125,10,1,3,22,47,125,44,104,357,260,97,1410,1198,212,0,13,6,0,18,16,245,69,35,143,117,50,47,0.461538461538462,34,0.529411764705882,1
"389","Roberto Soriano","VIL",1135,3,0,7,32,36,17,3,30,186,149,37,484,468,13,3,17,6,0,14,7,66,20,10,75,74,13,24,0.352941176470588,21,0.666666666666667,0
"390","Roberto","MGA",3060,0,0,0,3,1,0,0,0,17,1,16,908,149,759,0,1,0,0,0,0,266,0,0,1,0,15,1,0,0,0,1
"392","Rodri","VIL",3228,8,1,2,35,78,5,0,104,454,314,140,2470,2253,214,3,24,10,3,25,3,320,71,33,162,152,100,40,0.416666666666667,28,0.892857142857143,1
"393","Rodrigo Ely","ALA",2692,10,1,2,19,29,1,0,32,253,88,165,1027,753,272,2,15,4,0,3,0,129,18,14,49,39,114,51,0.266666666666667,3,1,1
"394","Rodrigo","VAL",2695,4,16,20,40,28,26,2,23,321,241,80,892,820,60,12,71,40,4,44,33,86,13,10,106,135,35,45,0.563380281690141,77,0.571428571428571,1
"396","Roger","LEV",962,4,3,5,14,17,6,0,8,112,78,34,189,175,12,2,20,8,2,13,5,34,4,4,34,44,10,24,0.4,18,0.722222222222222,0
"398","Ronaldo","RMA",2292,1,26,40,18,19,34,4,7,188,125,63,732,705,22,5,140,77,5,31,20,51,4,3,56,69,34,29,0.55,51,0.607843137254902,1
"400","Rubén Blanco","CEL",1942,3,0,0,0,1,0,0,0,9,3,6,736,277,459,0,0,0,0,0,0,157,0,0,0,3,6,0,0,0,0,1
"403","Rubén Peña","EIB",1727,1,1,5,18,15,70,0,41,187,151,36,726,601,125,0,9,2,0,20,20,130,28,13,78,73,15,21,0.222222222222222,40,0.5,0
"404","Rubén Pérez J.","LEG",2520,13,0,0,47,44,2,0,99,357,290,67,1489,1159,325,5,13,1,0,27,8,311,61,38,171,119,40,27,0.0769230769230769,35,0.771428571428571,1
"406","Rubén","DEP",2477,3,0,0,5,0,0,0,1,14,7,7,602,157,445,0,0,0,0,0,0,207,0,1,5,2,6,1,0,0,0,1
"407","Rukavina","VIL",1269,5,0,0,3,18,27,0,25,77,57,20,464,407,56,1,2,0,0,1,2,59,22,3,29,28,9,11,0,3,0.333333333333333,0
"408","Rulli","RSO",2340,3,0,0,2,1,0,0,2,11,9,2,996,545,451,0,0,0,0,0,0,210,1,1,3,6,2,0,0,0,0,1
"409","Ryad Boudebouz","BET",1361,2,2,1,17,21,31,23,32,208,180,28,803,740,59,4,14,12,3,38,26,65,18,14,87,93,6,22,0.857142857142857,64,0.59375,0
"410","S. Asenjo ","VIL",2070,3,0,0,3,2,0,0,2,20,10,10,535,149,386,0,0,0,0,1,0,208,2,0,4,6,9,1,0,1,1,1
"411","S. Castillejo","VIL",2083,4,6,7,66,42,52,73,40,404,346,58,885,812,66,7,41,19,5,47,59,121,28,12,153,193,15,43,0.463414634146341,106,0.443396226415094,1
"412","S. García","ESP",1629,4,2,13,35,18,19,0,15,224,173,51,427,400,26,1,33,17,6,22,25,65,12,3,71,102,17,34,0.515151515151515,47,0.468085106382979,0
"415","Saborit","ATH",1429,5,0,1,13,20,36,0,50,137,104,33,527,460,67,0,5,2,1,3,4,86,27,23,66,38,22,11,0.4,7,0.428571428571429,0
"418","Samuel Umtiti","BAR",2189,7,1,4,25,22,0,0,50,187,119,68,1618,1495,123,0,8,5,0,8,3,141,35,15,83,36,46,22,0.625,11,0.727272727272727,1
"420","San José","ATH",2156,5,1,0,8,39,11,0,52,328,202,126,1010,899,104,7,17,5,1,20,12,151,37,15,79,123,68,58,0.294117647058824,32,0.625,1
"421","Sanabria","BET",847,0,8,8,15,12,2,0,8,116,57,59,170,166,4,0,22,13,0,6,5,20,8,0,29,28,23,36,0.590909090909091,11,0.545454545454545,0
"422","Sandro","SEV",715,0,0,5,22,17,8,10,8,99,86,13,237,227,9,1,20,10,1,10,10,25,8,0,40,46,4,9,0.5,20,0.5,0
"424","Santi Mina","VAL",1549,4,12,11,36,24,6,0,17,259,165,94,466,441,23,2,33,20,2,19,9,50,9,8,70,95,37,57,0.606060606060606,28,0.678571428571429,0
"425","Saa Lukic","LEV",996,4,0,0,15,24,5,0,21,129,103,26,337,306,29,2,2,1,1,15,6,60,16,5,51,52,12,14,0.5,21,0.714285714285714,0
"426","Saúl","ATM",3157,9,2,5,35,67,19,0,132,593,416,177,1690,1571,115,4,39,9,3,59,37,237,90,42,225,191,76,101,0.230769230769231,96,0.614583333333333,1
"427","Savic","ATM",2299,6,0,0,8,24,3,0,30,155,88,67,988,776,212,0,1,1,0,4,0,115,20,10,42,46,46,21,1,4,1,1
"429","Sergi Enrich","EIB",1330,2,3,20,28,20,5,0,11,245,97,148,420,402,18,0,26,11,1,4,3,58,8,3,43,54,64,84,0.423076923076923,7,0.571428571428571,0
"430","Sergi Gómez","CEL",2682,3,1,2,6,14,3,0,52,187,88,99,1652,1419,232,1,11,2,0,1,2,135,37,15,59,29,63,36,0.181818181818182,3,0.333333333333333,1
"431","Sergi Roberto","BAR",2224,3,1,1,26,16,34,0,63,256,219,37,1617,1544,70,3,7,4,7,54,22,150,40,23,143,76,14,23,0.571428571428571,76,0.710526315789474,1
"432","Sergio A.","CEL",1475,0,0,0,5,0,0,0,0,13,4,9,575,253,322,0,0,0,0,1,0,123,0,0,3,1,8,1,0,1,1,0
"433","Sergio León","BET",1981,5,11,11,39,25,8,1,13,240,163,77,369,336,31,2,46,28,1,20,24,44,7,6,68,95,26,51,0.608695652173913,44,0.454545454545455,1
"434","Sergio Mora","GET",799,5,0,0,6,15,4,0,21,89,62,27,395,357,38,0,4,0,0,0,1,55,15,6,27,35,12,15,0,1,0,0
"435","Sergio Ramos","RMA",2290,7,4,6,20,37,9,0,40,246,111,135,1887,1648,234,5,27,14,1,9,2,195,29,11,68,43,85,50,0.518518518518518,11,0.818181818181818,1
"436","Sergio Rico","SEV",2155,2,0,0,3,1,0,0,1,19,5,14,549,209,340,0,0,0,0,0,0,186,1,0,2,3,13,1,0,0,0,1
"437","Sergio","BAR",2600,8,1,0,58,36,0,0,86,341,263,78,2241,2053,182,6,4,4,4,18,5,211,47,39,162,101,51,27,1,23,0.782608695652174,1
"438","Sidnei","DEP",1779,4,1,0,11,12,4,0,41,162,93,69,764,622,140,2,7,2,1,16,5,139,28,13,66,27,40,29,0.285714285714286,21,0.761904761904762,0
"439","Simon Kjaer","SEV",1571,3,2,0,9,18,1,0,35,136,67,69,788,680,108,0,7,2,0,1,0,69,24,11,44,23,44,25,0.285714285714286,1,1,0
"440","Simone Zaza","VAL",2078,8,13,16,32,41,9,0,21,353,193,160,451,424,24,3,57,24,1,13,35,43,14,7,63,130,77,83,0.421052631578947,48,0.270833333333333,1
"441","Siovas","LEG",2061,8,1,2,15,28,2,0,48,213,116,97,729,584,145,0,14,2,1,8,4,169,33,15,67,49,66,31,0.142857142857143,12,0.666666666666667,1
"442","Sisto","CEL",2534,2,5,10,74,15,64,26,18,360,344,16,980,877,97,6,39,19,9,75,56,156,12,6,167,177,1,15,0.487179487179487,131,0.572519083969466,1
"444","Sobrino","ALA",1461,5,3,6,32,37,13,0,33,319,190,129,389,377,12,0,23,13,2,25,14,76,24,9,85,105,59,70,0.565217391304348,39,0.641025641025641,0
"445","Stuani","GIR",2722,8,21,22,67,88,4,0,22,499,239,260,493,479,13,1,64,37,0,15,12,72,14,8,97,142,119,141,0.578125,27,0.555555555555556,1
"448","Susaeta","ATH",2268,2,3,10,50,20,74,86,42,312,278,34,848,779,67,2,18,12,2,37,35,142,29,13,128,150,10,24,0.666666666666667,72,0.513888888888889,1
"449","Szymanowski","LEG",1064,1,2,8,18,19,30,12,14,100,92,8,270,260,10,0,15,6,2,7,10,56,11,3,39,53,2,6,0.4,17,0.411764705882353,0
"450","T. Pina","ALA",2392,8,1,1,29,72,6,0,71,341,231,110,969,881,86,2,8,3,0,19,3,200,49,22,115,116,49,61,0.375,22,0.863636363636364,1
"451","Tana","LPA",1553,2,1,0,36,11,18,39,30,201,179,22,772,736,33,3,10,6,1,19,18,92,24,6,85,94,2,20,0.6,37,0.513513513513513,0
"452","Tello","BET",1684,2,4,10,20,14,20,5,32,187,177,10,683,644,34,5,27,16,3,42,20,108,24,8,94,83,5,5,0.592592592592593,62,0.67741935483871,0
"453","Ter Stegen","BAR",3330,0,0,0,1,0,0,0,1,7,4,3,1110,667,443,0,0,0,0,1,0,284,0,1,2,2,3,0,0,1,1,1
"454","Theo Hernández","RMA",961,1,0,1,15,11,30,0,21,133,120,13,551,534,16,1,2,2,0,22,18,68,15,6,58,62,10,3,1,40,0.55,0
"455","Thomas","ATM",2379,6,3,0,35,40,15,5,95,368,279,89,1378,1222,151,5,18,3,0,45,8,216,65,30,175,104,51,38,0.166666666666667,53,0.849056603773585,1
"456","Timor","GIR",922,8,2,0,10,16,3,0,17,99,62,37,464,387,77,0,9,5,0,1,2,65,10,7,26,36,24,13,0.555555555555556,3,0.333333333333333,0
"458","Toni Kroos","RMA",2267,4,5,2,38,21,48,132,55,215,197,18,2070,1871,190,9,31,17,7,24,8,151,35,20,117,80,11,7,0.548387096774194,32,0.75,1
"460","Toño","LEV",1080,2,0,0,8,6,43,0,12,78,70,8,425,349,74,2,1,1,1,24,7,56,11,1,44,26,2,6,1,31,0.774193548387097,0
"462","Unai Núñez","ATH",2942,11,1,0,24,42,3,0,73,303,186,117,1465,1148,316,1,19,2,0,17,3,172,52,21,110,76,74,43,0.105263157894737,20,0.85,1
"463","Varane","RMA",2323,2,0,0,12,19,1,0,28,157,79,78,1330,1183,147,0,9,2,1,9,2,144,19,9,48,31,50,28,0.222222222222222,11,0.818181818181818,1
"464","Vermaelen","BAR",1018,3,0,1,3,9,2,0,13,63,33,30,644,576,67,1,3,2,1,1,1,57,9,4,16,17,19,11,0.666666666666667,2,0.5,0
"465","Vesga","ATH",807,6,1,0,11,16,9,5,17,134,92,42,389,358,31,0,6,4,1,7,3,65,8,9,34,58,22,20,0.666666666666667,10,0.7,0
"466","Vezo","VAL",1554,1,0,1,13,23,15,0,43,176,118,58,715,627,88,0,2,1,0,11,6,94,24,19,66,52,40,18,0.5,17,0.647058823529412,0
"467","Vicente Gómez","LPA",1525,3,0,0,29,22,10,0,21,184,126,58,877,838,37,2,8,0,0,7,6,64,13,8,56,70,33,25,0,13,0.538461538461538,0
"469","Víctor Ruiz","VIL",2417,9,2,0,6,28,2,0,33,186,85,101,1420,1199,219,2,5,2,1,5,1,159,22,11,44,41,59,42,0.4,6,0.833333333333333,1
"470","Víctor S.","ESP",2463,13,0,0,50,72,58,9,105,403,322,81,1179,975,204,0,11,1,2,11,8,146,71,34,162,160,53,28,0.0909090909090909,19,0.578947368421053,1
"471","Viera","LPA",1994,4,4,3,69,21,24,41,36,328,299,29,1477,1380,76,21,32,16,3,64,34,101,25,11,168,131,9,20,0.5,98,0.653061224489796,1
"472","Vietto ","VAL",795,2,2,8,14,9,7,0,13,100,88,12,274,264,9,1,10,4,1,8,16,39,10,3,35,53,4,8,0.4,24,0.333333333333333,0
"473","Vigaray","ALA",893,6,0,0,13,18,17,0,27,91,78,13,240,200,39,1,4,1,0,3,7,48,16,11,43,35,6,7,0.25,10,0.3,0
"474","Vitolo","ATM",1309,1,2,5,51,24,9,1,24,229,197,32,644,628,16,0,13,6,2,34,16,78,18,6,108,89,11,21,0.461538461538462,50,0.68,0
"475","Vrsaljko","ATM",1697,6,0,3,12,30,78,3,48,203,137,66,628,559,69,0,3,0,4,11,12,68,30,18,70,67,45,21,0,23,0.478260869565217,0
"476","Wakaso","ALA",1097,7,0,3,22,31,17,4,43,190,154,36,421,331,89,1,7,1,1,17,7,85,30,13,82,72,17,19,0.142857142857143,24,0.708333333333333,0
"477","Wass","CEL",2938,4,4,11,53,26,100,73,30,279,178,101,1485,1366,115,4,41,11,9,11,13,164,21,9,91,87,49,52,0.268292682926829,24,0.458333333333333,1
"478","Williams","ATH",2851,2,7,26,41,31,63,0,28,399,313,86,680,654,22,4,59,26,6,61,60,110,17,11,129,184,39,47,0.440677966101695,121,0.504132231404959,1
"479","Willian José","RSO",2780,4,15,21,53,31,13,2,10,299,185,114,844,762,73,9,67,29,4,18,10,77,7,3,78,107,52,62,0.432835820895522,28,0.642857142857143,1
"480","Xabi Prieto","RSO",1940,1,3,4,32,15,55,12,18,174,111,63,994,958,35,1,15,10,5,20,7,89,14,4,66,45,34,29,0.666666666666667,27,0.740740740740741,1
"481","Ximo","LPA",2606,11,0,0,51,28,11,0,63,277,215,62,1335,1155,179,1,3,1,1,36,6,203,43,20,147,68,32,30,0.333333333333333,42,0.857142857142857,1
"482","Yeray","ATH",675,2,0,0,10,12,1,0,12,69,41,28,456,371,85,0,1,0,0,4,1,66,7,5,25,16,14,14,0,5,0.8,0
"485","Zaldúa","LEG",2560,9,1,2,62,43,78,0,68,336,264,72,857,720,137,0,8,3,0,31,26,122,52,16,159,105,48,24,0.375,57,0.543859649122807,1
"487","Zurutuza","RSO",2248,2,0,1,47,44,6,0,49,286,222,64,1145,1071,69,5,11,3,2,14,8,160,36,13,107,115,33,31,0.272727272727273,22,0.636363636363636,1
